NO ./textures/test.xpm
SO ./textures/test.xpm
WE ./textures/test.xpm
EA ./textures/test.xpm
DO ./textures/door.xpm

F 60,60,60
C 0,60,200

00000000000000000000000000000000000000
11111111111111111111111111111111111110
1S000000000000000000000000000000000001                                 11111
10000000001100000000000000000000000001                                 10001
1000000001  10000000000000000000000001                                 11111
10000000001100000000000011111111111111
1000000000000000000000001
1111111001000000100000001
       1000000000D00000001
        1110000000100000011111111011111
          10000001000000000000000000001
          10000011000000000000000000001
1111111111100001 100000000000000000001
10000000000000001000000000000000000001
10000000000000000000000000000000000001
10000000000000000000000000000000000001
10000000000000000000000000000000000001
11111111111111111111111111111111111111
