NO ./textures/test.xpm
EA ./textures/test.xpm
SO ./textures/test.xpm
WE ./textures/test.xpm

F 20,20,20
C 0,60,200

        1111111111111111111111111
        1000000000110000000000001
        1011000001110000000000001
        1001000000000000000W00001
111111111011000001110000000000001
100000000011000001111111110111111
11110111111111011100000010001
11110111111111011101010010001
11000000110101011100000010001
100N0000000000000000000011111
10000000000000001101000010001
11000001110101011111000000111
11110111 1110101 100000000001
11111111 1111111 111111111111
