NO ./textures/cyber.xpm
SO ./textures/cyber.xpm
WE ./textures/cyber.xpm
EA ./textures/cyber.xpm
F 10,10,15
C 5,5,10

111111
100001
1000N1
111111