NO ./textures/cyber.xpm
SO ./textures/cyber.xpm
WE ./textures/cyber.xpm
EA ./textures/cyber.xpm
F 10,10,15
C 5,5,10

1111111
1000001
100N001
1000001
1111111